#############        ########
###    ####    B ############
#####   ####     ############
######          #############
###A     #####    ###########
####        #####    ########
########                #####
##############       ########